Filename [Academy Valley]
Map Dimensions [60:60]
Tileset [Mech\Tileset0.jpg]
############################################
: Height Map
[636363636363636363636363636363636363636363636363636363636363636363636363636362616162626363636363636363636363636363636363]
[636363636363636363636363636363636363636313131313131313136363636363636363636261595959606061616162626363636363636363636363]
[636362636363626059606350506363636363131313131313131313131313636363636363635957565556575758585959606162626262636363636363]
[626260595958575654525150505050506313131313131313131313131313131313136363625049505152535455555656575860606061626363636363]
[585856545453525151505050505050501313131313131313131313131313131313131313153641444648495152525353545557585859606162636363]
[525251515050505050505050505050501313131313131313131313131313131313131313142633374143464749505051515353555657585960616363]
[505050505050505050505050383738131313131313131313131313131313131313131313142127323639424446485050505051535455565758596061]
[505050505050505049464038383725251313131313131313131313131313131313131313141923273134374042454749505050515253545556575859]
[505050505050504946433937342826241413131313131313131313131313131313131313141720242730333639424446485050505051525354555656]
[505050505050494844403734302624211413131313131313131313131313131313131312131417202427303336394144454749505050505152535454]
[505050505049484541373430272522181413131313131313131313131313131313131010121314182123263033363841434547485050505051515252]
[505050505046444138352927252420161413100401000000000000000000000000000408101313151821242730333638414345464850505050505151]
[505050494643403836302726252319151311070401000000000000000000000000000306091113141619222528313437394142444648505050505050]
[505049464240383735292625242117141109060301000000000000000000000000000204071013131517202326293235373940424446484950505050]
[504845423938373631272525231915131008050301000000000000000000000000000204060912131416192225283033363838404244454749505050]
[373940393837373429262525221713110907040201000000000000000000000000000103050811131315182023262932343738384041434547485050]
[383838373838363127252524201613110806040200000000000000000000000000000002050710121315171922252830333537373839414345464850]
[373838383737353126252523191512100805030100000000000000000000000000000002040609111314161821252629313436373838394142444646]
[373737373837333026252522181412090704020000000000000000000000000000000001030508101313151721242528303235373838373840414243]
[373837383736322725252420161311090604020000000000000000000000000000000000020407091213141720232527293134363737373838394040]
[383737383734302525252320151311080603010000000000000000000000000000000000020406091113141619232526283033353737383837383939]
[383737373632272525252320151310080503010000000000000000000000000000000000010305081012131619222425273032343637383838383838]
[373837373430262525242118131210070502010000000000000000000000000000000000010204071012131518212425262931333536383737383838]
[383837373328252525232016131209070402010000000000000000000000000000000000000204060911131417202325252830323436373838383838]
[383837363127252525221915131109060402000000000000000000000000000000000000000103050810121316182225252729313335373838373837]
[373837343026252524201714131108050301000000000000000000000000000000000000000102040710121315172124252628313335363738373837]
[373737342926252523201613121007050301000000000000000000000000000000000000000001030609111314172023252527303234363738373837]
[383737342926252523191513121007040200000000000000000000000000000000000000000000020508111314161922252526283133353737383737]
[383836332826252421181413120906030100000000000000000000000000000000000000000000010407111313151821252525272932343637383837]
[373837332825252420161413120804020100000000000000000000000000000000000000000000000206101313151720242525262830333537383838]
[383837342725252319151313120603010000000000000000000000000000000000000000000000000105091213141619232525252729313436383738]
[373738362625252117141313110602000000000000000000000000000000000000000000000000000104081213131619222525252628303234373738]
[373837372525252117131313120501000000000000000000000000000000000000000000000000000003071113131518212425252527293133353638]
[373838252525242016131313130300000000000000000000000000000000000000000000000000000001051013131517202325252526283031333435]
[383837252525231915131313130100000000000000000000000000000000000000000000000000000001040912131416192224252525272830313233]
[383737252525231814131313130000000000000000000000000000000000000000000000000000000001040811131315182123242525262728293031]
[383737252525221714131313130000000000000000000000000000000000000000000000000000000002040710131314171922242525252627282929]
[373838252524191513131313130000000000000000000000000000000000000000000000000000000001040710000000000000000000000000002727]
[383737252524171413131313130000000000000000000000000000000000000000000000000000000001040609000000000000000000000000002626]
[373838252523171413131313130000000000000000000000000000000000000000000000000000000001030608000000000000000000000000002626]
[383838252522171313131313130000000000000000000000000000000000000000000000000000000001030508000000000000000000000000002525]
[383826262421171413131313000000000000000000000000000000000000000000000000000000000001020406000000000000000000000000002525]
[252525252320171513131313000000000000000000000000000000000000000000000000000000000000010205000000000000000000000000002525]
[252525242220171514131313000000000000000000000000000000000000000000000000000000000000000103000000000000000000000000002525]
[252525232119171514131313000000000000000000000000000000000000000000000000000000000000000102000000000000000000000000002425]
[252524222018161513131300000000000000000000000000000000000000000000000000000000000000000002000000000000000000000000002223]
[252422211917151413131301000000000000000000000000000000000000000000000000000000000000000001000000000000000000000000002121]
[232221191716151313131103000000000000000000000000000000000000000000000000000000000000000000000000000000000000000000001819]
[202019171615141313110703010000000000000000000000000000000000000000000000000000000000000000000000000000000000000000001617]
[171716161514131313090502010000000000000000000000000000000000000000000000000000000000000000000000000000000000000000001415]
[141415141413131310070402010000000000000000000000000000000000000000000000000000000000000000000000000000000000000000000000]
[131313131313131208050301000000000000000000000000000000000000000000000000000000000000000000000000000000000000000000000000]
[131313131313120906030201000000000000000000000000000000000000000000000000000000000000000000000000000000000000000000001313]
[131313131312100705020100000000000000000000000000000000000000000000000000000000000000000000000000000000000000000000001010]
[131313131310080503010000000000000000000000000000000000000000000000000000000000000000000000000000000000000000000000000707]
[131313131108050302000000000000000000000000000000000000000000000000000000000000000000000000000000000000000000000000000404]
[131313110806030201000000000000000000000000000000000000000000000000000000000000000000000000000000000000000000000000000202]
[131210070503020100000000000000000000000000000000000000000000000000000000000000000000000000000000000000000000000000000100]
[010303030201000000000000000000000000000000000000000000000000000000000000000000000000000000000000000000000000000000000000]
[000001010100000000000000000000000000000000000000000000000000000000000000000000000000000000000000000000000000000000000000]
############################################
: Tile Map
[000000000000000000000000000000000000000000000000000000000000000000000000000000000000090909090909090909090909090909090909]
[000000000000000000000000000000000000000000000000000000000000000000000000000000000000060909090909090909090909090909090909]
[000000000000000000000000000000000000000000000000000000000000000000000000000000000000060606090909090909090909090909090909]
[000000000000000000000000000000000000000000000000000000000000000000000000000000000006060606060909090909090909090909090909]
[000000000000000000000000000000000000000000000000000000000000000000000000000000000606060606060909090909090909090909090909]
[000000000000000000000000000000000000000000000000000000000000000000000000000000000606060606060609090909090909090909090909]
[000000000000000000000000000000000000000000000000000000000000000000000000000000000606060606060606090909090909090909090909]
[000000000000000000000000000000000000000000000000000000000000000000000000000000000606060606060606060909090909090909090909]
[000000000000000000000000000000000000000000000005050500000000000000000000000000000606060606060606060609090909090909090909]
[000000000000000000000000000000000005050505050505050505050505050505050505050000000606060606060606060606090909090909090909]
[000000000000000000000000000000000005050505050505050505050505050505050505050000060606060606060606060606060909090909090909]
[000000000000000000000000000000000005050000000000000000000000000000000005050606060606060606060606060606060609090909090909]
[000000000000000000000000000000000005050000000000000000000100000000000005050606060606060606060606060606060606060909090909]
[000000000000000000000000000000000005050505050505050505050505050505050505050606060606060606060606060606060606060909090909]
[000000000000000000000000000000000005050505050505050505050505050505050505050606060606060606060606060606060606060609090909]
[000000000000000000000000000000000000000005050505050505050505050505050006060606060606060606060606060606060606060609090909]
[000000000000000000000000000000000000000005050505050505050505050505050606060606060606060606060606060606060606060609090909]
[000000000000000000000000000000000000000005050505050505050505050505050606060606060606060606060606060606060606060606090909]
[000000000000000000000000000000000000000005050505050505050505050505050606060606060606060606060606060606060606060606090909]
[000000000000000000000000000000000000000005050505050505050505050505050606060606060606060606060606060606060606060606060909]
[000000000000000000000000000000000000000005050505050505050505050505050606060606060606060606060606060606060606060606060909]
[000000000000000000000000000000000000000005050505050505050505050505050606060606060606060606060606060606060606060606060609]
[000000000000000000000000000000000000000005050505050505050505050505050606060606060606060606060606060606060606060606060606]
[000000000000000000000000000000000000000005050505050505050505050505050606060606060606060606060606060606060606060606060606]
[000000000000000000000000000000000000000005050505050505050505050505050606060606060606060606060606060606060606060606060606]
[000000000000000000000000000000000000000005050505050505050505050505050606060606060606060606060606060606060606060606060606]
[000000000000000000000000000000000000000005050505050505050505050505050606060606060606060606060606060606060606060606060606]
[000000000000000000000000000000000000000005050505050505050505050505050606060606060606060606060606060606060606060606060606]
[000000000000000000000000000000000000000000010101010104040101010101010606060606060606060606060606060606060606060606060606]
[000000000000000000000000000000000000000001010101010104040101010101010106060606060606060606060606060606060606060606060606]
[000000000000000000000000000000000000000001010101010104040101010101010106060606060606060606060606060606060606060606060606]
[000000000000000000000000000000000000000001010101010104040101010101010106060606060606060606060606060606060606060606060606]
[000000000000000000000000000000000000000001010101010104040101010101010106060606060606060606060606060606060606060606060606]
[000000000000000000000000000000000000000001010101010104040101010101010106060606060606060606060606060606060606060606060606]
[000000000000000000000000000000000000000101010101010104040101010101010106060606060606060606060606060606060606060606060606]
[000000000000000000000000000000000000000101010101010104040101010101010101060606060606060606060606060606060606060606060606]
[000000000000000000000000000000000000000101010101010104040101010101010101060606060606060606060606060606060606060606060606]
[000000000000000000000000000000000000010101010101010104040101010101010101010606060606060606050505050505050505050505050606]
[000000000000000000000000000000000000010101010101010104040101010101010101010606060606060606050505050505050505050505050606]
[000000000000000000000000000000000000010101010101010104040101010101010101010106060606060606050505050505050505050505050606]
[000000000000000000000000000000000000010101010101010104040101010101010101010106060606060606050505050505050505050505050606]
[000000000000000000000000000000000000010101010101010104040101010101010101010101060606060606050505050505050505050505050606]
[000000000000000000000000000000000001010101010101010104040101010101010101010101060606060606050505050505050505050505050606]
[000000000000000000000000000000000001010101010101010104040101010101010101010101010606060606050505050505050505050505050606]
[000000000000000000000000000000000001010101010101010104040101010101010101010101010606060606050505050505050505050505050606]
[000000000000000000000000000000000001010101010101010104040101010101010101010101010606060606050505050505050505050505050606]
[000000000000000000000000000000000001010101010101010104040101010101010101010101010106060606050505050505050505050505050606]
[000000000000000000000000000000000001010101010101010104040101010101010101010101010106060606050505050505050505050505050606]
[000000000000000000000000000000000001010101010101010104040101010101010101010101010106060606050505050505050505050505050606]
[000000000000000000000000000000000101010101010101010104040101010101010101010101010106060606050505050505050505050505050606]
[040404040404040404040404040404040404040404040404040404040404040404040404040404040404040404040404040404040404040404040404]
[040404040404040404040404040404040404040404040404040404040404040404040404040404040404040404040404040404040404040404040404]
[000000000000000000000000000001010101010101010101010101010101010101010101010101010101060606050505050505050505050505050606]
[000000000000000000000000000001010101010101010101010101010101010101010101010101010101010606050505050505050505050505050606]
[000000000000000000000000000001010101010101010101010101010101010101010101010101010101010106050505050505050505050505050606]
[000000000000000000000000000101010101010101010101010101010101010101010101010101010101010101050505050505050505050505050606]
[000000000000000000000000000101010101010101010101010101010101010101010101010101010101010101050505050505050505050505050606]
[000000000000000000000000010101010101010101010101010101010101010101010101010101010101010101050505050505050505050505050606]
[000000000000000000000001010101010101010101010101010101010101010101010101010101010101010101050505050505050505050505050606]
[000000000000000000010101010101010101010101010101010101010101010101010101010101010101010101050505050505050505050505050606]
############################################
:Object Pallete
Pallete Size [20]
Mesh    [Mech\Academy_house.3ds]		:1
Texture [Mech\Academy_house.jpg]
Logic   [Mech\Academy_house.log]

Mesh    [Mech\Academy.3ds]			:2
Texture [Mech\Academy.jpg]
Logic   [Mech\Academy.log]

Mesh    [Mech\Barracks.3ds]			:3
Texture [Mech\Barracks.jpg]
Logic   [Mech\Barracks.log]

Mesh    [Mech\Corner.3ds]			:4
Texture [Mech\Corner.jpg]
Logic   [Mech\Corner.log]

Mesh    [Mech\Wall.3ds]				:5
Texture [Mech\Wall.jpg]
Logic   [Mech\Wall.log]

Mesh    [Mech\Factory_house.3ds]		:6
Texture [Mech\Factory_house.jpg]
Logic   [Mech\Factory_house.log]

Mesh    [Mech\Corner2.3ds]			:7
Texture [Mech\Corner2.jpg]
Logic   [Mech\Corner2.log]

Mesh    [Mech\Training_halls.3ds]		:8
Texture [Mech\Training_halls.jpg]
Logic   [Mech\Training_halls.log]

Mesh    [Mech\Factory.3ds]			:9
Texture [Mech\Factory.jpg]
Logic   [Mech\Factory.log]

Mesh    [Mech\Warehouse.3ds]			:10
Texture [Mech\Warehouse.jpg]
Logic   [Mech\Warehouse.log]

Mesh    [Mech\Geyser.3ds]			:11
Texture [Mech\Geyser.jpg]
Logic   [Mech\Geyser.log]

Mesh    [Mech\SteamCatcher.3ds]			:12
Texture [Mech\SteamCatcher.jpg]
Logic   [Mech\SteamCatcher.log]

Mesh    [Mech\House.3ds]			:13
Texture [Mech\House.jpg]
Logic   [Mech\House.log]

Mesh    [Mech\CityHall.3ds]			:14
Texture [Mech\CityHall.jpg]
Logic   [Mech\CityHall.log]

Mesh    [Mech\BigBoomWreck.3ds]			:15
Texture [Mech\BigBoomWreck.jpg]
Logic   [Mech\BigBoomWreck.log]

Mesh    [Mech\LumberJackWreck.3ds]		:16
Texture [Mech\LumberJackWreck.jpg]
Logic   [Mech\LumberJackWreck.log]

Mesh    [Mech\SteamFiendWreck.3ds]		:17
Texture [Mech\SteamFiendWreck.jpg]
Logic   [Mech\SteamFiendWreck.log]

Mesh    [Mech\Rat-a-tatWreck.3ds]		:18
Texture [Mech\Rat-a-tatWreck.jpg]
Logic   [Mech\Rat-a-tatWreck.log]

Mesh    [Mech\Slice-n-DiceWreck.3ds]		:19
Texture [Mech\Slice-n-DiceWreck.jpg]
Logic   [Mech\Slice-n-DiceWreck.log]

Mesh    [Mech\SteamCopterWreck.3ds]		:20
Texture [Mech\SteamCopterWreck.jpg]
Logic   [Mech\SteamCopterWreck.log]
############################################
:Object List
List Size [84]
[11:01:45:0:20]	:SteamCopterWreck
[05:37:12:0:19]	:Slice-n-DiceWreck
[11:15:18:0:18]	:Rat-a-tatWreck
[02:09:45:0:16]	:LumberJackWreck
[07:25:16:0:17]	:SteamFiendWreck
[02:23:36:0:15]	:BigBoomWreck
[08:51:00:0:14]	:CityHall
[28:37:00:0:13]	:House
[53:10:50:0:11]	:Geyser
[46:34:14:0:11]	:Geyser
[53:34:25:0:11]	:Geyser
[50:32:25:0:11]	:Geyser
[50:29:25:0:11]	:Geyser
[44:30:13:0:11]	:Geyser
[51:8:50:0:12]	:SteamCatcher
[49:26:25:0:12]	:SteamCatcher
[56:13:50:0:11]	:Geyser
[48:06:50:0:11]	:Geyser
[57:2:63:0:11]	:Geyser
[55:0:63:0:12]	:SteamCatcher
[51:0:63:0:11]	:Geyser
[47:39:0:0:10]	:Warehouse
[47:52:0:0:9]	:Factory
[23:52:0:0:8]	:Training_halls
[14:33:0:0:1]	:Academy_house
[19:2:13:0:2]	:Academy
[30:13:0:1:3]	:Barracks
[33:27:0:2:7]	:Corner2
[20:27:0:3:4]	:Corner
[32:27:0:2:5]	:Wall
[31:27:0:2:5]
[30:27:0:2:5]
[28:27:0:3:4]	:Corner
[26:27:0:2:7]	:Corner2
[37:15:4:2:7]
[25:27:0:2:5]
[24:27:0:2:5]
[23:27:0:2:5]
[22:27:0:2:5]
[20:19:0:3:5]
[20:18:0:3:5]
[20:17:0:3:5]
[20:16:0:3:5]
[20:26:0:3:5]
[20:25:0:3:5]
[20:24:0:3:5]
[20:23:0:3:5]
[20:22:0:3:5]
[20:21:0:3:5]
[20:20:0:3:5]
[20:15:2:2:5]
[19:15:3:2:5]
[18:15:5:2:5]
[16:15:7:3:4]	:Corner
[16:14:8:3:5]
[16:13:9:3:5]
[16:12:11:3:5]
[16:11:12:3:5]
[16:10:13:3:5]
[16:09:14:3:5]
[33:25:0:1:5]
[33:24:0:1:5]
[33:23:0:1:5]
[33:22:0:1:5]
[33:21:0:1:5]
[33:20:0:1:5]
[33:19:0:1:5]
[33:18:0:1:5]
[33:17:0:1:5]
[33:16:0:1:5]
[33:15:0:1:5]
[33:15:0:1:5]
[34:15:0:2:5]
[35:15:1:2:5]
[36:15:4:2:5]
[37:13:8:1:5]
[37:12:9:1:5]
[37:11:10:1:5]
[37:10:11:1:5]
[37:09:12:1:5]
[37:08:14:1:5]
[37:07:16:1:5]
[28:48:0:3:6]	:Factory_house
[28:34:0:3:6]
############################################
:Game Infomation (Optional)
Gamemode[Melee]
Teams[2]
Deploy[1,TLX,TLY,BRX,BRY]
Deploy[2,TLX,TLY,BRX,BRY]
EndGameMode
Gamemode[KingofHill]
Teams[2]
King[1,TLX,TLY,BRX,BRY]
Peroid[50]
KingPoints[-100]
EndGameMode
############################################