Filename [BigGeyser]
Map Dimensions [60:60]
Tileset [Mech\Tileset0.jpg]
############################################
: Height Map
[504948474645444342424242424242424242424242424242424242424242424242424242424242444617000000000435504846444242424242424242]
[494847464544434242424242424242424242424242424242424242424242424242424242424242444616000000012848504846444242424242444442]
[484746454443424242424242424242424242424242424242424242424242424242424242424244464109000000134150484644424242424244464442]
[474645444342424242424242424242424242424242424242424242424242424242424242424444483702000005385048464442424242424446464442]
[464544434242424242424242424242424242424242424242424242424242424242424242424446482400000017464846444242424242444748464442]
[454443424242424242424242424242424242424242424242424242424242424242424242444546380500000033444644424242424244464849464442]
[444342424242424242424242424242424242424242424242424242424242424242424242444529070000000740424442424242424446485048464442]
[434242424242424242424242424242424242424242424242424242424242424242424242443101000000002542424242424242424446485048464442]
[424242424242424242424242424242424242424242424242424242424242424242424244370600000000033842424242424242424244464850464442]
[424242424242424242424242424242424242424242424242424242424242424242424444150000000000134142424242424242424244464850464442]
[424242424242424242424242424242424242424242424242424242424242424242424436020000000000254242424442424238414446485051474442]
[424242424242424242424242424242424242424242424242424242424242424242444112000000000000284244464646444226384446485048464442]
[424242424242424242424242424242424242424242424242424242424242424242442700000000000000324246484848464124394446485048464442]
[424242424242424242424242424242424242424242424242424242424242424244330400000000000000274246485148464416364244464849464442]
[424242424242424242424242424242424242424242424242424242424242424405070000000000000000254244484848443704364242444648464442]
[424242424242424242424242424242424242424242424242424242424242443407000000000000000000094142464645421602394244464850464242]
[424242424242424242424242424242424242424242424242424242424444280400000000000000000000013342424442290109414446485048464442]
[444444424242424242424242424242444444444444444444424242443815000000000000000000000000000425342613000030424446485048464442]
[464646444444424242424242424244464646464646464646444240280500000000000000000000000000000000000000001239424446485048464442]
[484848464646444442424242424446484848484848484848382807000000000000000000000000000000000000000000174042424446464848464442]
[494949494949464644424242424446495050505050503516040000000000000000000000000000000000000000000832424242424446464646464442]
[505050505050504744424242424446495050504132130200000000000000000000000000000000000000000001173842424242424446464644444242]
[515151515151504844424242424447495038260800000000000000000000000000000000000000000000071535424242424242424244444444424242]
[515151515151514844424242424446331704000000000000000000000000000000000000000005072432414242424242424242424242424242424242]
[494949494947464444424242332607020000000000000000000000000000000000000000082840464544424242424242424242424242424242424242]
[464646464647423736341609010000000000000000000000000000000000000000000013394847464544424242424242424242424242424242424242]
[162837383526130200000000000000000000030826261704040000000000000000001039494847464544424242424242424242424242424242424242]
[000001010100000000000000000000000012384150505040402605000000000000073948494847464544424242424242424242424242424242424242]
[000000000000000000000000000000093241484950505050505027000000000001294950494847464544424242424242424242424242424242424242]
[000000000000000000000000032431424446484950505050505038010000000008484950494847464442424242424242424242424242424242424242]
[000000000000000000001224384242444547474849505050505038010000000027475049484746454442424242424242424242424242424242424242]
[000506091012313436364242424242444546464748495050505038010000000032485049484746454442424242424242424242424242424242424242]
[293948484848484442424242424242424445464749495050505038010000000539495049484746454442424242424242424242424242424242424242]
[464646444444444242424242424242424445464748494949494938010000000842424242424242424242424242424242424242424242424242424242]
[444444424242424242424242424242424445464748494949494938020000000842424242424242424242424242424242424242424242424242424242]
[424242424242424242424242424242424244454647484949494939040000000842424242424242424242424242424242424242424242424242424242]
[424242424242424242424242424242424242424242424242424240040000000842424242424242424242424242424242424242424242424242424242]
[424244424242424242424242424242424242424242424242424240040000000235424242424242424242424242424242424242424242424242424242]
[424242424242424242424242424242424242424242424242424241140000000031424242424242424242424242424242424242424242424242424242]
[424242424242424242424242424242424242424242424242424242270000000031424242424242424242424242424242424242424242424242424242]
[424242424242424242424242424242424242424242424242424242290000000029424242424242424242424242424242424242424242424242424242]
[424242424242424242424242424242424242424242424242424242290000000026424242424242424242424242424242424242424242424242424242]
[424242424242424242424242424242424242424242424242424242340200000011424242424242424242424242424242424242424242424242424242]
[424242424242424242424242424242424242424242424242424242000000000007424242424242424242424242424242424242424242424242424242]
[424242424242424242424242424242424242424242424242424242000000000004424242424242424242424242424242424242424242424242424242]
[424242424242424242424242424242424242424242424242424242421000000000344242424242424242424242424242424242424242424242424242]
[464646424242424242424242424242424242424242424242424242422900000000244242424242424242424242424242424242424242424242424242]
[484848424242424242424242424242424242424242424242424242423300000000154242424242424242424242424242424242424242424242424242]
[525150424242424242424242424242424242424242424242424242423200000000033842424242424242424242424242424242424242424242424242]
[525150424242424242424242424242424242424242424242424242423500000000003342424242424242424242424242424242424242424242424242]
[525150424242424242424242424242424242424242424242424242423601000000001442424242424242424242424242424242424242424242424242]
[525150424242424242424242424242424242424242424242424242424114000000001142424242424242424242424242424242424242424242424242]
[525150424242424242424242424242424242424242424242424242424236020000000540424242424242424242424243434345464646454545424242]
[525150424242424242424242424242424242424242424242424244444446150000000032424242424242424242424245454547494949484848454444]
[525150434242424242424242424242424242424242424448484848484848360400000024424242424242444445464648484850525252515050494847]
[525150444342424242424242424242424242424242444648505051515050463000000006424242424344454647484950515253545555545352515049]
[525150454443424242424242424242424242424242464848505051515050464009000000324242424344454647484950515253545555545352515049]
[504850464544434242424242424242424242424242444648505051515050464217000000154242424344454647484950515253545555545352515049]
[504950474645444342424242424242424242424242424648505051515050464236030000033442424344454647484950515253545555545352515049]
[505050484746454443424242424242424242424242424447505051515050464241060000000838424344454647484950515253545555545352515049]
############################################
: Tile Map
[060606060606060404060606060606060606060606060604040606060606060606060606060606060606000000000000060606060606060606060606]
[060606060606060404060606060606060606060606060604040606060606060606060606060606060600000000000606060606060606060606060606]
[060606060606060606060606060606060606060606060606060606060606060606060606060606060606000000060606060606060606060606060606]
[060606060606060606060606060606060606060606060606060606060606060606060606060606060606000000060606060606060606060606060606]
[060606060606060606060606060606060606060606060606060606060606060606060606060606060600000006060606060606060606060606060606]
[060606060606060606060606060606060606060606060606060606060606060606060606060606060600000006060606060606060606060606060606]
[060606060606060606060606060606060606060606060606060606060606060606060606060606060000000606060606060606060606060606060606]
[060606060606060606060606060606060606060606060606060606060606060606060606060606000000000606060606060606060606060606060606]
[060606060606060606060606060606060606060606060604040606060606060606060606060600000000060606060606060606060606060606060606]
[060606060606060606060606060606060606060606060604040606060606060606060606060000000000060606060606060606060606060606060606]
[060606060606060606060606060606060606060606060604040606060606060606060606060000000000060606060606060606060606060606060606]
[060606060606060606060606060606060606060606060604040606060606060606060606000000000000060606060606060606060606060606060606]
[060606060606060606060606060606060606060606060604040606060606060606060600000000000000060606060606060606060606060606060606]
[060606060606060606060606060606060606060606060604040606060606060606060600000000000000060606060606060606060606060606060606]
[060606060606060404060606060606060606060606060604040606060606060606060000000000000000060606060606060606060606060606060606]
[040404040404040404040404040404040404040404040404040606060606060606000000000000000000060606060606060606060606060606060606]
[040404040404040404040404040404040404040404040404040606060606060600000000000000000000060606060606060606060606060606060606]
[060606060606060606060404060606060606060606060606060606060606000000000000000000000000000006060606060606060606060606060606]
[060606060606060606060404060606060606060606060606060606060600000000000000000000000000000000000000000606060606060606060606]
[060606060606060606060404060606060606060606060606060606000000000000000000000000000000000000000000060606060606060606060606]
[060606060606060606060404060606060606060606060606060000000000000000000000000000000000000000000606060606060606060606060606]
[060606060606060606060404060606060606060606060600000000000000000000000000000000000000000006060606060606060606060606060606]
[060606060606060606060404060606060606060600000000000000000000000000000000000000000000060606060606060606060606060606060606]
[060606060606060606060404060606060606000000000000000000000000000000000000000006060606060606060604040404040404040404040404]
[060606060606060606060404060606060000000000000000000000000000000000000000060606060606060606060604040404040404040404040404]
[060606060606060606060606060000000000000000000000000000000000000000000006060606060606060606060604040606060606060606060606]
[060606060606060600000000000000000000010101010101010000000000000000000606060606060606060606060604040606060606060606060606]
[000000000000000000000000000000000001010101010101010101000000000000060606060606060606060606060604040606060606060606060606]
[000000000000000000000000000000010101010101010101010101000000000006060606060606060606060606060604040606060606060606060606]
[000000000000000000000000000101010101010101010101010101010000000006060606060606060606060606060604040606060606060606060606]
[000000000000000000000000010101010101010101010101010101010000000006060606060606060606060606060604040606060606060606060606]
[000101010101010101010404010101010101010101010101010101010000000006060606060606060606060606060604040505050505050506060606]
[010101010101010101010404010101010101010101010101010101010000000606060606060606060606060606060604040505050505050506060606]
[010101010101010101010404010101010101010101010101010101010000000606060606060606060606060606060604040505050505050506060606]
[040404040404040404040404040404040101010101010101010101010000000606060606060606060606060606060604040505050505050506060606]
[040404040404040404040404040404040101010101010101010101010000000606060404040406060606060606040404040505050505050506060606]
[010101010101010101010101010104040101010101010101010101010000000606060404040406060606060606040404040505050505050506060606]
[010101010101010101010101010104040101010101010101010101010000000606060404040406060606060606040404040505050505050506060606]
[010101010101010101010101010104040101010101010101010101010000000006060404040406060606060606040404040505050505050506060606]
[010101010101010101010101010104040101010101010101010101010000000006060404040406060606060606040404040606060606060606060606]
[010101010101010101010101010104040101010101010101010101010000000006060404060606060606060606060604040606060606060606060606]
[010101010101010101010101010104040104040401010404040101010000000006060404060606060606060606060604040606060606060606060606]
[010101010101010101010101010104040104040401010404040101010100000006060404060606060606060606060604040606060606060606060606]
[010101010101010101010101010104040404040404040404040404000000000000040404040404040404040404040404040404040404040404040404]
[010101010101010101010101010104040404040404040404040404000000000000040404040404040404040404040404040404040404040404040404]
[010101010101010101010101010104040101010104040401010101010100000000060606060606060606060606060404060606040406060606060606]
[010101010101010101010101010104040101010104040401010101010100000000060606060606060606060606060404060606040406060606060606]
[010101010101010101010101010104040101010101010101010101010100000000060606060606060606060606060606060606060606060606060606]
[010101010101010101010101010104040101010101010101010101010100000000060606060606060606060606060606060606060606060606060606]
[010101010101010101010101040404040101010101010101010101010100000000000606060606060606060606060606060606060606060606060606]
[010101010101010101010101040404040101010101010101010101010101000000000606060606060606060606060606060606060606060606060606]
[010101010101010101010101040404040101010101010101010101010101000000000606060606060606060606060606060606060606060606060606]
[010101010101010101010101040404040101010101010101010101010101010000000606060606060606060606060606060606060606060606060606]
[010101010101010101010101010104040101010101010101010101010101010000000006060606060606060606060606060606060606060606060606]
[010101010101010101010101010104040101010101010101010101010101010000000006060606060606060606060606060606060606060606060606]
[010101010101010101010101010104040101010101010101010101010101010000000006060606060606060606060606060606060606060606060606]
[010101010101010101010101010104040101010101010101010101010101010100000000060606060606060606060606060606060606060606060606]
[010101010101010101010101010104040101010101010101010101010101010101000000060606060606060606060606060606060606060606060606]
[010101010101010101010101010104040101010101010101010101010101010101000000060606060606060606060606060606060606060606060606]
[010101010101010101010101010104040101010101010101010101010101010101010000000606060606060606060606060606060606060606060606]
############################################
:Object Pallete
Pallete Size [20]
Mesh    [Mech\Bridge2x6.3ds]			:1
Texture [Mech\Bridge2x6.jpg]
Logic   [Mech\Bidge2x6.log]

Mesh    [Mech\Academy.3ds]				:2
Texture [Mech\Academy.jpg]
Logic   [Mech\Academy.log]

Mesh    [Mech\Barracks.3ds]				:3
Texture [Mech\Barracks.jpg]
Logic   [Mech\Barracks.log]

Mesh    [Mech\Corner2.3ds]				:4
Texture [Mech\Corner2.jpg]
Logic   [Mech\Corner2.log]

Mesh    [Mech\Wall.3ds]					:5
Texture [Mech\Wall.jpg]
Logic   [Mech\Wall.log]

Mesh    [Mech\House.3ds]				:6
Texture [Mech\House.jpg]
Logic   [Mech\House.log]

Mesh    [Mech\Geyser.3ds]				:7
Texture [Mech\Geyser.jpg]
Logic   [Mech\Geyser.log]

Mesh    [Mech\SteamCatcher.3ds]			:8
Texture [Mech\SteamCatcher.jpg]
Logic   [Mech\SteamCatcher.log]

Mesh    [Mech\Turret.3ds]				:9
Texture [Mech\Turret.jpg]
Logic   [Mech\Turret.log]

Mesh    [Mech\Corner.3ds]				:10
Texture [Mech\Corner.jpg]
Logic   [Mech\Corner.log]

Mesh    [Mech\Academy_house.3ds]		:11
Texture [Mech\Academy_house.jpg]
Logic   [Mech\Academy_house.log]

Mesh    [Mech\CityHall.3ds]				:12
Texture [Mech\CityHall.jpg]
Logic   [Mech\CityHall.log]

Mesh    [Mech\Factory.3ds]				:13
Texture [Mech\Factory.jpg]
Logic   [Mech\Factory.log]

Mesh    [Mech\Factory_house.3ds]		:14
Texture [Mech\Factory_house.jpg]
Logic   [Mech\Factory_house.log]

Mesh    [Mech\Training_halls.3ds]		:15
Texture [Mech\Training_halls.jpg]
Logic   [Mech\Training_halls.log]

Mesh    [Mech\Warehouse.3ds]			:16
Texture [Mech\Warehouse.jpg]
Logic   [Mech\Warehouse.log]

Mesh    [Mech\Gear.3ds]					:17
Texture [Mech\Gear.jpg]
Logic   [Mech\Gear.log]

Mesh    [Mech\LumberJackWreck.3ds]		:18
Texture [Mech\LumberJackWreck.jpg]
Logic   [Mech\LumberJackWreck.log]

Mesh    [Mech\SteamFiendWreck.3ds]		:19
Texture [Mech\SteamFiendWreck.jpg]
Logic   [Mech\SteamFiendWreck.log]

Mesh    [Mech\SteamCopterWreck.3ds]		:20
Texture [Mech\SteamCopterWreck.jpg]
Logic   [Mech\SteamCopterWreck.log]
############################################
:Object List
List Size [60]
[47:32:42:1:16]	:Warehouse
[56:30:42:1:13]	:Factory
[19:2:42:0:2]	:Academy
[2:2:42:0:11]	:Academy_house
[14:45:42:1:12]	:CityHall
[3:38:42:0:3]	:Barracks
[24:29:50:0:7]	:Geyser
[37:29:48:1:8]	:SteamCatcher
[19:28:50:0:7]
[21:28:48:0:8]
[35:27:50:0:7]	:Geyser
[39:26:46:0:7]
[20:32:50:0:7]
[12:25:42:1:1]	:Bridge2x6
[27:43:42:0:1]
[30:11:42:2:5]	:Wall
[29:11:42:2:5]
[28:11:42:2:5]
[31:11:42:2:5]
[22:11:42:2:4]	:Corner2
[32:11:42:2:4]
[26:11:42:3:10]	:Corner
[21:11:42:2:5]
[20:11:42:2:5]
[19:11:42:2:5]
[18:11:42:2:5]
[16:11:42:3:10]	:Corner
[16:10:42:3:5]	:Wall
[16:09:42:3:5]
[16:08:42:3:5]
[16:07:42:3:5]
[16:06:42:3:9]	:Turret
[16:05:42:3:5]	:Wall
[16:04:42:3:5]
[16:03:42:3:5]
[16:02:42:3:5]
[16:09:42:3:5]
[16:01:42:3:5]
[32:09:42:1:5]
[32:08:42:1:5]
[32:07:42:1:5]
[32:06:42:1:5]
[32:05:42:1:9]	:Turret
[32:04:42:1:5]	:Wall
[32:03:42:1:5]
[32:02:42:1:5]
[32:01:42:1:5]
[32:00:42:1:5]
[27:46:42:1:9]	:Turret
[27:41:42:1:9]
[17:46:42:0:15]	:Training_halls
[22:41:42:3:6]	:House
[17:41:42:3:6]
[50:47:42:0:14]	:Factory_house
[45:47:42:0:14]
[7:19:43:0:17]	:Gear
[44:30:42:1:17]
[49:8:39:3:18]	:LumberJackWreck
[54:17:39:3:19]	:SteamFiendWreck
[46:58:43:3:20]	:SteamCopterWreck
############################################
:Game Infomation (Optional)
Gamemode[Melee]
Teams[2]
Deploy[1,TLX,TLY,BRX,BRY]
Deploy[2,TLX,TLY,BRX,BRY]
EndGameMode
Gamemode[KingofHill]
Teams[2]
King[1,TLX,TLY,BRX,BRY]
Peroid[50]
KingPoints[-100]
EndGameMode
############################################