Filename [Test Map]
Map Dimensions [50:50]
Tileset [Mech\Tileset0.jpg]
############################################ 
: Height Map 
[2320030000000000000000000000000000000000000925252525252525252525252525252525252525252525252525252525] 
[2323170100000000000000000000000000000000000523252525252525252525252525252525252525252525252525252525] 
[2323231704000000000000000000000000000000000221252525252525252525252525252525252525252525252525252525] 
[1222232322140200000000000000000000000000000013252525252525252525252525252525252525252525252525252525] 
[0009222323232112130801000000000000000000000004222525252525252525252525252525252525252525252525252525] 
[0000092223232323232218140400000000000000000000112425252525252525252525252525252525252525252525252525] 
[0000000622232323232323232104000000000000000000011725252525252525252525252525252525252525252525252525] 
[0000000522232323232323232316000000000000000000000219252525252525252525252525252525252525252525252525] 
[0000000116232323232323232320000000000000000000000002192525252525252525252525252525252525252525252525] 
[0000000002132323232323232320000000000000000000000000011725252525252525252525252525252525252525252525] 
[0000000000001122232323232314000000000000000000000000000015252525252525252525252525252525252525252525] 
[0000000000000002101615161202000000000000000000000000000000122325252525252525252525252525252525252525] 
[0000000000000000000000000000000000000000000000000000000000000620252525252525252525252525252525252525] 
[0000000000000000000000000000000000000000000000000000000000000001102125252525252525252525252525252525] 
[0000000000000000000000000000000000000000000000000000000000000000000211232525252525252525252525252525] 
[0000000000000000000000000000000000000000000000000000000000000000000000052225252525252525252525252525] 
[0000000000000000000000000014141414141414001400000000000000000000000000000521252525252525252525252525] 
[0000000000000000000000000014000000000000001400000000000000000000000000000004192425252525252525252525] 
[0000000000000000000000000014001414141414001400000000000000000000000000000000021121252525252525252422] 
[0000000000000000000000000014001400000014001400000000000000000000000000000000000003091619212120171105] 
[0000000000000000000000000014001400140014001400000000000000000000000000000000000000000101020302010000] 
[0000000000000000000000000014001400140014001400000000000000000000000000000000000000000000000000000000] 
[0000000000000000000000000014001400140000001400000000000000000000000000000000000000000000000000000000] 
[0000000000000000000000000014001400141414141400000000000000000000000000000000000000000000000000000000] 
[0000000000000000000000000014000000000000000000000000000000000000000000000000000000000000000000000000] 
[0303040301000000000000000014141414141414141400000000000000000000000000000000000000000000000000000000] 
[1111111006020000000000000000000000000000000000000000000000000000000000000000000000000000000000000000] 
[1818191713080300000000000000000000000000000000000000000000000000000000000000000000000000000000000000] 
[2121212119140903000000000000000000000000000000000000000000000000000000000000000000000000000000000000] 
[2121212121191407020000000000000000000000000000000000000000000000000000000000000000000000000000000000] 
[2121212121211711040000000000000000181919191919191919191918181800000000000000000000000000000000000000] 
[1121212121212015060100000000000000181919181819191919181918181403000000000000000000000000000000000000] 
[0018212121212118090300000000000000191919181919191819181817141004000000000000000000000000000000000000] 
[0000212121212120140601000000000000191918181919191919181614110704010000000000000000000000000000000000] 
[0000002121212121180904000000000000191919191918181918151210070503010000000000000000000000000000000000] 
[0000000221212121201708030000000000191918181818191917120806040201000000000000041616050000000000000000] 
[0000000000212121212116100501000000191818181819181817040302010000000000000000172323221805000000000000] 
[0000000000002121212120171307030000000000000000000000000000000000000000000000172323232321080100000000] 
[1100000000000021212121211914080300000000000000000000000000000000000000000000052123232323231913080100] 
[2117000000000000212121212119150906020000000000000000000000000000000000000000001123232323232323231301] 
[2121210000000000002121212121201713080401000000000000000000000000000000000000000213212323232323232314] 
[2121212100000000212121212121212120151007040100000000000000000000000000000000000000000419232323232323] 
[2121212121210021212121212121212121201815110702000000000000000000000000000000000000000002192323232323] 
[2121212121212121212121210000212121212120181409060200000000000000000000000000000000000000032223232323] 
[2121212121212121212121000000002121212121211917141106010000000000000000000000000000000000001823232323] 
[2121212121212121212121000000000021212121212121201714110401000000000000000000000000000000001723232323] 
[2121212121212121212121210000000000000021212121212120171307020000000000000000000000000000000822232323] 
[2121212121212121212121212121000000000000002121212121201814090706060301000000000000000000000112232323] 
[2121212121212121212121212121210000000000000017212121212019171616151207040100000000000000000000172323] 
[2121212121212121212121212121212121000000000000022121212121212120201815080300000000000000000000042223] 
############################################ 
: Tile Map 
[0202020202020202020202020202020202020202010101010101010101010101010101010101010101010101010101010101] 
[0202020202020202020202020202020202020202020101010101010101010101010101010101010101010101010101010101] 
[0202020202020202020202020202020202020202020101010101010101010101010101010101010101010101010101010101] 
[0202020202020202020202020202020202020202020101010101010101010101010101010101010101010101010101010101] 
[0202020202020202020202020202020202020202020201010101010101010101010101010101010101010101010101010101] 
[0202020202020202020202020202020202020202020201010101010101010101010101010101010101010101010101010101] 
[0202020202020202020202020202020202020202020202010101010101010101010101010101010101010101010101010101] 
[0202020202020202020202020202020202020202020202020101010101010101010101010101010101010101010101010101] 
[0202020202020202020202020202020202020202020202020201010101010101010101010101010101010101010101010101] 
[0202020202020202020202020202020202020202020202020202010101010101010101010101010101010101010101010101] 
[0202020202020202020202020202020202020202020202020202020101010101010101010101010101010101010101010101] 
[0202020202020202020202020202020202020202020202020202020201010101010101010101010101010101010101010101] 
[0202020202020202020202020202020202020202020202020202020202020101010101010101010101010101010101010101] 
[0202020202020202020202020202020202020202020202020202020202020201010101010101010101010101010101010101] 
[0202020202020202020202020202020202020202020202020202020202020202020101010101010101010101010101010101] 
[0202020202020202020202020202020202020202020202020202020202020202020202010101010101010101010101010101] 
[0202020202020202020202020204040404040404020402020202020202020202020202020101010101010101010101010101] 
[0202020202020202020202020204020202020202020402020202020202020202020202020201010101010101010101010101] 
[0202020202020202020202020204020404040404020402020202020202020202020202020202010101010101010101010101] 
[0202020202020202020202020204020402020204020402020202020202020202020202020202020101010101010101010101] 
[0202020202020202020202020204020402040204020402020202020202020202020202020202020202020101010101010101] 
[0202020202020202020202020204020402040204020402020202020202020202020202020202020202020202020202020202] 
[0202020202020202020202020204020402040202020402020202020202020202020202020202020202020202020202020202] 
[0202020202020202020202020204020402040404040402020202020202020202020202020202020202020202020202020202] 
[0202020202020202020202020204020202020202020202020202020202020202020202020202020202020202020202020202] 
[0202020202020202020202020204040404040404040402020202020202020202020202020202020202020202020202020202] 
[0202020202020202020202020202020202020202020202020202020202020202020202020202020202020202020202020202] 
[0202020202020202020202020202020202020202020202020202020202020202020202020202020202020202020202020202] 
[0404040402020202020202020202020202020202020202020202020202020202020202020202020202020202020202020202] 
[0404040402020202020202020202020202020202020202020202020202020202020202020202020202020202020202020202] 
[0404040404020202020202020202020202030303030303030303030303030202020202020202020202020202020202020202] 
[0404040404040202020202020202020202030303030303030303030303030202020202020202020202020202020202020202] 
[1014040404040202020202020202020202030303030303030303030302020202020202020202020202020202020202020202] 
[1010140404040402020202020202020202030303030303030303020202020202020202020202020202020202020202020202] 
[1010140404040404020202020202020202030303030303030303020202020202020202020202020202020202020202020202] 
[1010101404040404020202020202020202030303030303030302020202020202020202020202020202020202020202020202] 
[1010101010140404040202020202020202030303030303030302020202020202020202020202020202020202020202020202] 
[1010101010101404040402020202020202020202020202020202020202020202020202020202020202020202020202020202] 
[0410101010101014040404020202020202020202020202020202020202020202020202020202020202020202020202020202] 
[0404101010101010140404040202020202020202020202020202020202020202020202020202020202020202020202020202] 
[0404041010101010101404040402020202020202020202020202020202020202020202020202020202020202020202020202] 
[0404040410101010140404040404040402020202020202020202020202020202020202020202020202020202020202020202] 
[0404040404041014040404040404040404020202020202020202020202020202020202020202020202020202020202020202] 
[0404040404040404040404041010140404040202020202020202020202020202020202020202020202020202020202020202] 
[0404040404040404040404101010101404040404040202020202020202020202020202020202020202020202020202020202] 
[0404040404040404040404101010101014040404040402020202020202020202020202020202020202020202020202020202] 
[0404040404040404040404041010101010101014040404040402020202020202020202020202020202020202020202020202] 
[0404040404040404040404040404101010101010101404040404020202020202020202020202020202020202020202020202] 
[0404040404040404040404040404041010101010101014040404040202020202020202020202020202020202020202020202] 
[0404040404040404040404040404040404101010101010140404040402020202020202020202020202020202020202020202] 
############################################
:Object Pallete
Pallete Size [1]
Mesh    [Mech\bridge2x6.3ds]
Texture [Mech\bridge2x6.jpg]
Logic   [Mech\bridge2x6.log]
############################################
:Object List
List Size [1]
[25:25:10:1:1]
############################################
:Game Infomation (Optional)
Gamemode[Melee]
Teams[2]
Deploy[1,TLX,TLY,BRX,BRY]
Deploy[2,TLX,TLY,BRX,BRY]
EndGameMode
Gamemode[KingofHill]
Teams[2]
King[1,TLX,TLY,BRX,BRY]
Peroid[50]
KingPoints[-100]
EndGameMode
############################################